19 19 19 19 19 19 19 19 19 19 19 19 19 19 19 19 19 19 19 19 19 19 19 19 19 19 19 19 19 19 19 19 19 19 19 19 19 19 19 19 19 19 19 19 19 19 19 19 19 19 
19 19 19 19 19 19 19 29 22 22 22 22 22 22 22 22 22 22 22 22 22 22 22 22 30 19 19 19 19 19 19 19 19 19 19 19 19 19 19 19 19 19 19 19 19 19 19 19 19 19 
19 19 19 19 19 19 19 20 25 25 25 25 25 25 25 25 25 25 25 25 25 25 25 25 18 19 19 19 29 22 22 22 22 22 22 22 22 22 30 19 19 29 22 22 22 22 22 30 19 19 
19 19 19 19 19 19 19 20 25 25 25 25 25 25 25 25 25 25 25 25 25 25 25 25 18 19 19 19 20 25 25 25 25 25 25 25 25 25 18 19 19 20 25 25 25 25 25 18 19 19 
19 19 19 19 19 19 19 20 25 25 25 25 25 25 25 25 25 25 25 25 25 25 25 25 21 22 22 22 23 25 25 25 25 25 25 25 25 25 18 19 19 20 25 25 25 25 25 18 19 19 
19 19 19 19 19 19 19 20 25 25 25 25 25 25 25 25 25 25 25 25 25 25 25 25 25 25 25 25 25 25 25 25 25 25 25 25 25 25 18 19 19 20 25 25 25 25 25 18 19 19 
19 19 19 19 19 19 19 20 25 25 25 25 25 25 25 25 25 25 25 25 25 25 25 25 12 13 13 13 14 25 25 25 25 25 25 25 25 25 18 19 19 20 25 25 25 25 25 18 19 19 
19 19 19 19 19 19 19 20 25 25 25 25 25 25 25 25 25 25 25 25 25 25 25 25 18 19 19 19 20 25 25 25 25 25 25 25 25 25 21 22 22 23 25 25 25 25 25 18 19 19 
19 19 19 19 19 19 19 20 25 12 13 13 13 13 13 14 25 25 25 25 25 25 25 25 18 19 19 19 20 25 25 25 25 25 25 25 25 25 25 25 25 25 25 25 25 25 25 18 19 19 
19 19 19 19 19 19 19 20 25 18 19 19 19 19 19 20 25 25 25 25 25 25 25 25 18 19 19 19 20 25 25 25 25 25 25 25 25 25 25 25 25 25 25 25 25 25 25 18 19 19 
19 19 19 19 19 29 22 23 25 21 22 30 19 19 19 27 13 13 13 13 13 13 13 13 28 19 19 19 20 25 25 25 25 25 25 25 25 25 25 25 25 25 25 25 25 25 25 18 19 19 
19 19 19 19 19 20 25 25 25 25 25 18 19 19 19 19 19 19 19 19 19 19 19 19 19 19 19 19 20 25 25 25 25 25 25 25 25 25 25 25 25 25 25 25 25 25 25 18 19 19 
19 19 19 19 19 20 25 25 25 25 25 18 19 19 19 19 19 19 19 19 19 19 19 19 19 19 19 19 20 25 25 25 25 25 25 25 25 25 25 25 25 25 25 25 25 25 25 18 19 19 
19 19 19 19 19 20 25 25 25 25 25 21 22 22 22 22 22 22 22 22 22 22 30 19 19 19 19 19 27 13 13 13 13 13 13 13 13 13 13 13 13 13 13 14 25 12 13 28 19 19 
19 19 19 19 19 20 25 25 25 25 25 25 25 25 25 25 25 25 25 25 25 25 18 19 19 19 19 19 19 19 19 19 19 19 19 19 19 19 19 19 19 19 19 20 25 18 19 19 19 19 
19 19 19 19 19 20 25 25 25 25 25 25 25 25 25 25 25 25 25 25 25 25 21 22 22 30 19 19 19 19 19 19 19 19 19 19 19 19 19 19 29 22 22 23 25 21 22 22 22 30 
19 19 19 19 19 20 25 25 25 25 25 25 25 25 25 25 25 25 25 25 25 25 25 25 25 18 19 19 19 19 19 19 19 19 19 19 19 19 19 19 20 25 25 25 25 25 25 25 25 18 
19 19 19 19 19 20 25 25 25 25 25 25 25 25 25 25 25 25 25 25 25 25 12 14 25 21 22 22 30 19 19 19 19 19 19 19 19 19 19 19 20 25 25 25 25 25 25 25 25 18 
19 19 19 19 19 20 25 25 25 25 25 25 25 25 25 25 25 25 25 25 25 25 18 20 25 25 25 25 18 19 29 22 22 22 22 22 30 19 19 19 20 25 25 25 25 25 25 25 25 18 
19 19 19 19 19 27 13 13 13 13 13 13 14 25 12 13 13 13 13 13 13 13 28 20 25 25 25 25 18 19 20 25 25 25 25 25 18 19 19 19 20 25 25 25 25 25 25 25 25 18 
19 19 19 19 19 19 19 19 19 19 19 19 20 25 18 19 19 19 29 22 22 22 22 23 25 25 25 25 18 19 20 25 25 25 25 25 18 19 19 19 20 25 25 25 25 25 25 25 25 18 
19 19 19 19 19 19 19 19 19 19 29 17 23 25 21 22 30 19 20 25 25 25 25 25 25 25 25 25 18 19 20 25 25 25 25 25 18 19 29 22 23 25 25 25 25 25 25 25 25 18 
19 19 19 19 19 19 19 19 19 19 20 25 25 25 25 25 18 19 20 25 25 25 25 25 25 25 25 25 18 19 20 25 25 25 25 25 18 19 20 25 25 25 25 25 25 25 25 25 25 18 
19 19 19 19 19 19 19 19 19 19 20 25 25 25 25 25 18 19 20 25 25 25 25 25 25 25 25 25 18 19 20 25 25 25 25 25 18 19 20 25 25 25 25 25 25 25 25 25 25 18 
19 19 19 19 19 19 19 19 19 19 20 25 25 4 25 25 18 19 20 25 25 25 25 25 25 25 25 25 18 19 20 25 25 25 25 25 18 19 20 25 25 25 25 25 25 25 25 25 25 18 
19 19 19 19 19 19 19 19 19 19 20 25 25 25 25 25 18 19 27 13 13 13 14 25 12 13 13 13 28 19 20 25 25 25 25 25 18 19 20 25 25 25 25 25 25 25 25 25 25 18 
19 19 19 19 19 19 19 19 19 19 20 25 25 25 25 25 18 19 19 19 19 19 20 25 18 19 19 19 19 19 20 25 12 14 25 12 28 19 20 25 25 25 25 25 25 25 25 25 25 18 
19 19 19 19 19 19 19 19 19 19 20 25 25 25 25 25 18 19 19 29 22 22 23 25 21 22 22 22 30 19 20 25 18 20 25 21 22 22 23 25 25 25 25 25 25 25 25 25 25 18 
19 19 19 19 19 19 19 19 19 19 27 13 13 13 13 13 28 19 29 23 25 25 25 25 25 25 25 25 18 19 20 25 18 20 25 25 25 25 25 25 25 25 25 25 25 25 25 25 25 18 
29 22 22 22 22 22 22 22 22 22 22 30 19 19 19 19 19 29 23 25 25 25 25 25 25 25 25 25 18 19 20 25 18 27 13 13 13 13 14 25 25 25 25 25 25 25 25 25 25 18 
20 25 25 25 25 25 25 25 25 25 25 18 19 19 19 19 29 23 25 25 25 25 25 25 25 25 25 25 18 19 20 25 18 19 19 19 19 19 29 25 25 25 25 25 25 25 25 25 25 18 
20 25 25 25 25 25 25 25 25 25 25 18 19 19 19 19 20 25 25 25 25 25 25 25 25 25 25 25 18 19 20 25 18 19 19 19 19 19 27 13 13 13 13 13 13 13 13 13 13 28 
20 25 25 25 25 25 25 25 25 25 25 21 22 22 22 22 23 25 25 25 25 25 25 25 25 25 25 25 18 19 20 25 18 19 19 19 19 19 19 19 19 19 19 19 19 19 19 19 19 19 
20 25 25 25 25 25 25 25 25 25 25 25 25 25 25 25 25 25 25 25 25 25 25 25 25 25 25 25 18 19 20 25 18 19 19 19 29 22 22 22 22 22 22 22 22 22 22 22 22 30 
20 25 25 25 25 25 25 25 25 25 25 12 13 13 13 13 14 25 25 25 25 25 25 25 25 25 25 25 18 19 20 25 18 19 19 19 20 25 25 25 25 25 25 25 25 25 25 25 25 18 
20 25 25 25 25 25 25 25 25 25 25 18 19 19 19 19 20 25 25 25 25 25 25 25 25 25 25 12 28 19 20 25 18 19 19 19 20 25 25 25 25 25 25 25 25 25 25 25 25 18 
20 25 25 25 25 25 25 25 25 25 25 18 19 19 19 19 27 13 13 13 13 13 13 13 13 13 13 28 19 29 23 25 21 22 30 19 20 25 25 25 25 25 25 25 25 25 25 25 25 18 
20 25 25 25 25 25 25 25 25 25 25 18 19 19 19 19 19 29 22 22 22 22 30 19 19 19 19 19 19 20 25 25 25 25 18 19 20 25 25 25 25 25 25 25 25 25 25 25 25 18 
20 25 25 25 25 25 25 25 25 25 25 18 19 19 19 19 19 20 25 25 25 25 18 19 19 19 19 19 19 20 25 25 25 25 18 19 20 25 25 25 25 25 25 25 25 25 25 25 25 18 
20 25 25 25 25 25 25 25 25 25 25 18 19 19 19 19 19 20 25 25 25 25 18 19 19 19 19 19 19 20 25 25 25 25 18 19 20 25 25 25 25 25 25 25 25 25 25 25 25 18 
20 25 25 25 25 25 25 25 25 25 25 18 19 19 19 19 19 20 25 25 25 25 18 19 19 19 19 19 19 20 25 25 25 25 18 19 20 25 25 25 25 25 25 25 25 25 25 25 25 18 
20 25 25 25 25 25 25 25 25 25 25 18 19 19 19 19 19 20 25 25 25 25 18 19 19 19 19 19 19 20 25 25 25 25 21 22 23 25 25 25 25 25 25 25 25 25 25 25 25 18 
20 25 25 25 25 25 25 25 25 25 25 18 19 19 19 19 19 20 25 25 25 25 18 19 19 19 19 19 19 20 25 25 25 25 25 25 25 25 25 25 25 25 25 25 25 25 25 25 25 18 
20 25 25 25 25 25 25 25 25 25 25 21 22 22 22 22 22 23 25 25 25 25 21 22 22 22 22 22 22 23 25 25 25 25 12 13 14 25 25 25 25 25 25 25 25 25 25 25 25 18 
20 25 25 25 25 25 25 25 25 25 25 25 25 25 25 25 25 25 25 25 25 25 25 25 25 25 25 25 25 25 25 25 25 25 18 19 20 25 25 25 25 25 25 25 25 25 25 25 25 18 
20 25 25 25 25 25 25 25 25 25 25 12 13 13 13 13 13 13 13 13 13 13 13 13 13 13 13 13 13 13 13 13 13 13 28 19 20 25 25 25 25 25 25 25 25 25 25 25 25 18 
27 13 13 13 13 13 13 13 13 13 13 28 19 19 19 19 19 19 19 19 19 19 19 19 19 19 19 19 19 19 19 19 19 19 19 19 20 25 25 25 25 25 25 25 25 25 25 25 25 18 
19 19 19 19 19 19 19 19 19 19 19 19 19 19 19 19 19 19 19 19 19 19 19 19 19 19 19 19 19 19 19 19 19 19 19 19 20 25 25 25 25 25 25 25 25 25 25 25 25 18 
19 19 19 19 19 19 19 19 19 19 19 19 19 19 19 19 19 19 19 19 19 19 19 19 19 19 19 19 19 19 19 19 19 19 19 19 20 25 25 25 25 25 25 25 25 25 25 25 25 18 
19 19 19 19 19 19 19 19 19 19 19 19 19 19 19 19 19 19 19 19 19 19 19 19 19 19 19 19 19 19 19 19 19 19 19 19 27 13 13 13 13 13 13 13 13 13 13 13 13 28 
